@@@@@@@@@@@@@@@@@@@@
@@T##########M###O@@
@@@@@M@@@@#@@@@@@@O@
@#####@@@@#@@####M#@
@T@@M@@@@@#@@###T@@@
@@@@#@@@###@##M@@O#@
@@T#M#@@#@@@#@@@###@
@@@@@#@@@@@@#@@@###@
@@@@@#@@@S##M#T@##T@
@@@##M@@@#@@@@@###@@
@@@#@@@@@#@@T####@@@
@M####T@@#@@@@B@@@@@
@#@@#@@@@M@@#####T@@
@#@@#@@@@#@@@M@@@@@@
@#T@#M@@@#@@@##@@#T@
@@#@@##T@#@@@@M@@M@@
@@M@@@@O@#M#@@##@#@@
@@#####@##@#@@@#@#@@
@@@@@M###@@T###M##@@
@@@@@@@@@@@@@@@@@@@@