@@@@@@@@@@
@#M###T@T@
@@@@#@@##@
@T#@#M##@@
@@M@#@@#M@
@#####@@#@
@T@@#@T##@
@#@@M@@@@@
@M###MBTO@
@@@@@@@@@@