@@@@@@@@@@@@@@@@@@@@
@@@TTT#######O@@@@O@
@@@#########@@@@@@T@
@@@@@B@@@@@@@@@@@@#@
@@@######M####@@@@#@
@@@@@@@@@@#####T@@#@
@@@@@@@@@MMMM@@@@@#@
@@@@@@T######@@@@@#@
@@@@@@@@@@####@@@@#@
@@@@@@@@@######@@@#@
@@@@@@@@@@#######@#@
@@@@T#####M######@#@
@@@###MMMM@@@@@@@@#@
@@@@@@######T@@@@@#@
@@@@@@MMMMMM@@@@@@#@
@@@@##########@@@@#@
@@@#########@@@@@@#@
@@@S@@@@@@@@@@@@@@#@
@@@M###############@
@@@@@@@@@@@@@@@@@@@@