@@@@@@@@@@@@@@@@@@@@
@@T@@@TM######TO@@@@
@@##@@@@##@@M@@@@@@@
@@@M@@@#M@@@#@@@@@@@
@@@###@#@@@@#####@@@
@OT@@##T@@@@@@@T###@
@###T@M@@@@@@@@#@@#@
@####@##M#@@@@@@@@#@
@B@@T@#@@###@@@@@@M@
@###@@#@@@@###@####@
@@@M###@@@@@@#M#@@@@
@@@#@@##M#@@@@@###@@
@@@#@@T#@##@@@@@##S@
@@@#@@@M@###O@@@@@#@
@@@M@@@##@####T@@@M@
@@@##@@@#@@@##@@T##@
@@@@##@@#@@@@M@@#@@@
@@@@@M##T@@@@#@@#@@@
@@T###@@@@@@@####@@@
@@@@@@@@@@@@@@@@@@@@